1111111111111
10010000000C1
1000011111001
1P0011E000001
10010000000C1
100100V0000C1
10010000000C1
10010000000C1
10010000000C1
10010000000C1
100000V000001
1000000000001
100000V000001
1000000000001
10010000000C1
10010000000C1
10010000000C1
10010000000C1
10010000000C1
10010000000C1
10010000000C1
10010000000C1
1000000000001
1000000000001
1000000000001
1000000000001
10010000000C1
10010000000C1
10010000000C1
10010000000C1
10010000000C1
10010000000C1
10010000000C1
10010000V00C1
1000000000001
1000V00000001
1000000000001
1000000000001
10010000000C1
10010000000C1
10010000000C1
1111111111111